{
  "1": "1",
  "2": "2",
  "3": "3",
  "4": "4",
  "5": "5",
  "6": "6",
  "7": "7",
  "8": "8",
  "9": "9",
  "0": "0",
  "-": "-",
  "=": "=",
  "q": "ු",
  "w": "අ",
  "e": "ැ",
  "r": "ර",
  "t": "එ",
  "y": "හ",
  "u": "ම",
  "i": "ස",
  "o": "ද",
  "p": "ච",
  "[": "ඤ",
  "]": ";",
  "\\": "්‍",
  "a": "්",
  "s": "ි",
  "d": "ා",
  "f": "ෙ",
  "g": "ට",
  "h": "ය",
  "j": "ව",
  "k": "න",
  "l": "ක",
  ";": "ත",
  "'": ".",
  "z": "'",
  "x": "ං",
  "c": "ජ",
  "v": "ඩ",
  "b": "ඉ",
  "n": "බ",
  "m": "ප",
  ",": "ල",
  ".": "ග",
  "/": "/",
  "!": "!",
  "@": "@",
  "#": "#",
  "$": "$",
  "%": "%",
  "^": "^",
  "&": "&",
  "*": "*",
  "(": "(",
  ")": ")",
  "_": "_",
  "+": "+",
  "Q": "ූ",
  "W": "උ",
  "E": "ෑ",
  "R": "ඍ",
  "T": "ඔ",
  "Y": "ශ",
  "U": "ඹ",
  "I": "ෂ",
  "O": "ධ",
  "P": "ඡ",
  "{": "ඥ",
  "}": ":",
  "|": "‍්",
  "A": "ෟ",
  "S": "ී",
  "D": "ෘ",
  "F": "ෆ",
  "G": "ඨ",
  "H": "්‍ය",
  "J": "ළු",
  "K": "ණ",
  "L": "ඛ",
  ":": "ථ",
  "\"": ",",
  "Z": "\"",
  "X": "ඞ",
  "C": "ඣ",
  "V": "ඪ",
  "B": "ඊ",
  "N": "භ",
  "M": "ඵ",
  "<": "ළ",
  ">": "ඝ",
  "?": "?"
}
